1 1 1 1 1 1 1 1 1 1 1 1 1 1 1 1 1 1 1 1 1 1 1 1 1 1 1 1 1 1 1 1 1 1 1 1 1 1 1 1 1 1 1 1 1 1 1 1 1 1 1 1 1 1 1 1 1 1 1 1 1 1 1 1 1
1 6 0 0 0 0 1 1 1 1 1 1 1 1 0 1 6 6 0 0 0 0 0 0 0 0 0 0 0 0 0 1 6 6 6 0 0 0 1 1 1 1 1 1 1 1 0 0 0 6 6 6 6 0 0 1 1 1 1 1 1 1 1 0 1
1 0 0 0 0 0 1 0 0 0 0 0 0 0 0 1 0 0 0 0 6 0 6 0 6 0 6 0 6 0 6 1 0 0 0 0 0 0 1 0 0 0 0 0 0 0 0 1 0 0 0 0 0 0 1 0 0 0 0 0 0 0 1 0 1
1 0 0 0 0 0 1 0 1 1 1 1 1 0 0 1 0 0 0 0 0 6 0 6 0 6 0 6 0 6 0 1 0 0 0 0 0 0 1 0 1 1 1 1 1 0 0 1 0 0 0 0 0 0 1 0 1 1 1 1 1 0 1 0 1
1 0 0 0 0 0 1 0 0 0 0 0 1 0 0 1 0 0 0 0 6 0 0 0 0 2 2 2 2 2 2 1 0 0 0 0 0 0 1 0 0 0 0 0 1 0 0 1 0 0 0 0 0 0 1 0 0 0 0 0 1 0 1 0 1
1 0 0 2 0 0 1 1 1 1 1 0 1 0 0 1 0 0 0 0 0 6 0 0 2 0 0 0 0 0 2 1 0 0 0 2 0 0 1 1 1 1 1 1 1 0 0 1 0 0 0 2 0 0 1 1 1 1 1 1 1 0 1 0 1
1 0 2 2 0 0 0 0 0 0 0 0 0 0 0 1 0 0 0 0 6 0 0 2 2 0 0 0 0 0 2 1 0 0 2 2 0 0 0 0 0 0 0 0 0 0 0 1 0 0 2 2 0 0 0 0 0 0 0 0 0 0 1 0 1
1 0 2 2 2 0 0 0 0 0 0 0 0 0 0 1 0 0 0 0 0 6 2 2 0 0 0 0 0 0 2 1 0 0 2 2 2 0 0 0 0 0 0 0 0 0 0 1 0 0 2 2 2 0 0 0 0 0 0 0 0 0 1 0 1
1 0 2 2 2 2 0 0 0 0 0 0 0 0 0 1 0 0 0 0 6 2 2 0 0 0 0 0 0 0 0 1 0 0 2 2 2 2 0 0 0 0 0 0 0 0 0 1 0 0 2 2 2 2 0 0 0 0 0 0 0 0 0 0 1
1 0 0 0 0 0 0 0 0 0 0 0 0 0 0 1 0 0 4 4 4 4 4 0 0 0 0 0 0 0 0 1 0 0 0 0 0 0 0 0 0 0 0 0 0 0 0 1 0 0 0 0 0 0 0 0 0 0 0 0 0 0 0 0 1
1 0 2 2 2 2 0 0 0 0 0 0 0 0 0 0 0 0 2 2 6 0 0 0 0 0 0 0 0 0 1 1 0 0 2 2 2 2 0 0 0 0 0 0 0 0 0 1 0 0 2 2 2 2 0 0 0 0 0 0 0 0 1 0 1
1 0 0 2 2 0 0 0 0 0 0 0 0 0 1 1 0 0 2 2 0 6 0 0 0 0 0 0 0 0 1 1 0 0 0 2 2 0 0 0 0 0 0 0 0 0 0 1 0 0 0 2 2 0 0 0 0 0 0 0 0 0 1 0 1
1 1 1 1 1 1 1 1 1 1 1 1 1 1 1 1 1 1 1 1 1 1 1 1 1 1 1 1 1 0 1 1 1 1 1 1 1 1 1 1 1 1 1 1 1 1 0 1 0 1 1 1 1 1 1 1 1 1 1 1 1 1 1 1 1
1 6 6 6 6 4 4 4 4 4 4 4 4 4 4 1 6 6 6 6 0 0 0 0 0 0 0 0 0 0 0 1 6 6 6 6 0 0 0 0 0 0 0 0 0 0 0 1 0 6 6 6 6 0 1 1 1 1 1 1 1 1 1 0 1
1 6 4 4 4 4 4 4 4 4 4 4 4 4 4 1 6 6 0 0 0 0 1 0 0 0 0 0 0 0 0 1 6 6 6 0 0 0 1 0 0 0 0 0 0 0 0 1 0 6 6 6 6 0 0 0 0 1 0 0 0 0 0 0 1
1 4 4 4 4 4 4 4 4 4 4 4 4 4 4 1 4 4 0 0 0 0 1 5 5 5 5 5 5 0 0 1 0 0 0 0 0 0 1 0 1 1 1 1 1 0 0 1 0 0 0 0 0 0 1 0 1 1 1 1 1 0 1 0 1
1 4 4 4 4 4 4 4 4 4 4 4 4 4 4 1 4 4 0 0 0 0 1 5 5 5 5 5 5 0 0 1 0 0 0 0 0 0 1 0 0 0 0 0 1 0 0 1 0 0 0 0 0 0 1 0 0 0 0 0 1 0 1 0 1
1 4 4 4 4 4 4 4 4 4 4 4 4 4 4 4 4 0 0 2 0 0 1 1 1 1 1 1 1 0 0 1 0 0 0 2 0 0 1 1 1 1 1 1 1 0 0 1 0 0 0 2 0 0 1 1 1 1 1 1 1 0 1 0 1
1 4 4 4 4 4 4 4 4 4 4 4 4 4 4 1 0 0 0 0 0 0 0 0 0 0 0 0 0 0 0 1 0 0 2 2 0 0 0 0 0 0 0 0 0 0 0 1 0 0 2 2 0 0 0 0 0 0 0 0 0 0 1 0 1
1 4 4 4 4 4 4 4 4 4 4 4 4 4 4 1 2 2 2 2 2 2 2 2 2 2 2 2 2 2 2 1 0 0 2 2 2 0 0 0 0 0 0 0 0 0 0 1 0 0 2 2 2 0 0 0 0 0 0 0 0 0 1 0 1
1 4 4 4 4 4 4 4 4 4 4 4 4 4 4 1 2 2 2 2 2 2 2 2 2 2 2 2 2 2 2 1 0 0 2 2 2 2 0 0 0 0 0 0 0 0 0 1 0 0 2 2 2 2 0 0 0 0 0 0 0 0 0 0 1
1 4 4 4 4 4 4 4 4 4 4 4 4 4 4 1 3 3 3 3 7 3 3 3 3 3 3 3 3 3 3 1 0 0 0 0 0 0 0 0 0 0 0 0 0 0 0 1 0 0 0 0 0 0 0 0 0 0 0 0 0 0 0 0 1
1 4 4 4 4 4 4 4 4 4 4 4 4 4 4 1 3 3 7 3 3 3 7 3 3 3 3 3 3 3 3 1 0 0 2 2 2 2 0 0 0 0 0 0 0 0 0 1 0 0 2 2 2 2 0 0 0 0 0 0 0 0 1 0 1
1 0 4 4 4 4 4 4 4 4 4 4 4 4 4 1 3 3 3 3 3 3 3 3 3 3 3 3 3 3 3 3 3 3 3 3 3 3 3 3 3 3 3 3 3 3 3 1 0 0 0 2 2 0 0 0 0 0 0 0 0 0 1 0 1
1 0 1 1 1 1 1 1 1 1 1 1 1 1 1 1 0 1 1 1 1 1 1 1 1 1 1 1 1 1 1 1 1 1 1 1 1 1 1 1 1 1 1 1 1 1 1 1 1 1 1 1 1 1 1 1 1 1 1 1 1 1 1 0 1
1 0 6 6 6 6 6 0 0 0 0 0 0 0 0 1 0 6 6 6 6 6 0 0 0 0 0 0 0 0 0 1 6 6 6 6 6 6 2 2 2 2 2 2 2 2 2 1 6 6 6 6 6 6 0 0 0 0 0 0 0 0 0 0 1
1 0 6 6 6 6 0 0 0 0 0 0 0 0 0 1 0 6 6 6 6 6 1 0 0 0 0 0 0 0 0 1 6 6 6 6 6 0 1 0 0 0 0 0 0 0 1 1 6 6 6 6 6 6 1 0 0 0 0 0 0 0 0 0 1
1 0 0 0 0 0 0 0 1 1 1 1 1 0 0 1 0 0 0 0 0 0 1 0 1 1 1 1 1 0 0 1 0 0 0 0 0 0 1 0 1 1 1 1 1 0 1 1 0 0 0 0 0 0 1 0 1 1 1 1 1 0 0 0 1
1 0 0 0 0 0 1 0 0 0 0 0 1 0 0 1 0 0 0 0 0 0 1 0 0 0 0 0 1 0 0 1 0 0 0 0 0 0 1 0 0 0 0 0 1 0 1 1 0 0 0 0 0 0 1 0 0 0 0 0 1 0 0 0 1
1 0 0 2 0 0 1 1 1 1 1 1 1 0 0 1 0 0 0 2 0 0 1 1 1 1 1 1 1 0 0 1 0 0 0 2 0 0 1 1 1 1 1 1 1 0 1 1 0 0 0 2 0 0 1 1 1 1 1 1 1 0 0 0 1
1 0 2 2 0 0 0 0 0 0 0 0 0 0 0 1 0 0 2 2 0 0 0 0 0 0 0 0 0 0 0 1 0 0 2 2 0 0 0 0 0 0 0 0 0 0 0 1 0 0 2 2 0 0 0 0 0 0 0 0 0 0 0 0 1
1 0 2 2 2 0 0 0 0 0 0 0 0 0 0 1 0 0 2 2 2 0 0 0 0 0 0 0 0 0 0 1 0 0 2 2 2 0 0 0 0 0 0 0 0 0 0 1 0 0 2 2 2 0 0 0 0 0 0 0 0 0 0 0 1
1 0 2 2 2 2 0 0 0 0 0 0 0 0 0 1 0 0 2 2 2 2 0 0 0 0 0 0 0 0 0 1 0 0 2 2 2 2 0 0 0 0 0 0 0 0 0 1 0 0 2 2 2 2 0 0 0 0 0 0 0 0 0 0 1
1 0 0 0 0 0 0 0 0 0 0 0 0 0 0 1 0 0 0 0 0 0 0 0 0 0 0 0 0 0 0 1 0 0 0 0 0 0 0 0 0 0 0 0 0 0 0 1 0 0 0 0 0 0 0 0 0 0 0 0 0 0 0 0 1
1 0 2 2 2 2 0 0 0 0 0 0 0 0 0 1 0 0 2 2 2 2 0 0 0 0 0 0 0 0 0 1 0 0 2 2 2 2 0 0 0 0 0 0 0 0 0 1 0 0 2 2 2 2 0 0 0 0 0 0 0 0 0 0 1
1 0 0 2 2 0 0 0 0 0 0 0 0 0 0 1 0 0 0 2 2 0 0 0 0 0 0 0 0 0 0 1 0 0 0 2 2 0 0 0 0 0 0 0 0 0 0 0 0 0 0 2 2 0 0 0 0 0 0 0 0 0 0 0 1
1 1 0 1 1 1 1 1 1 1 1 1 1 1 1 1 1 1 1 1 1 1 1 1 1 1 1 1 1 0 1 1 1 1 1 1 1 1 0 1 1 1 1 1 1 1 1 1 1 1 1 1 1 1 1 1 1 1 1 1 1 1 1 1 1
1 6 0 6 6 6 6 6 0 0 0 0 0 0 0 1 6 6 6 6 6 6 0 1 1 1 1 1 1 0 1 1 6 6 6 6 6 6 0 1 1 1 1 1 1 1 1 1 0 0 0 0 0 0 0 0 0 0 0 0 0 0 0 0 1
1 6 0 6 6 6 6 6 0 0 0 0 0 0 0 1 6 6 6 6 6 6 0 0 0 0 0 0 0 0 1 1 6 6 6 6 6 6 0 0 0 0 0 0 0 0 1 1 0 0 0 0 0 0 0 0 1 1 0 0 0 0 0 0 1
1 6 0 0 0 0 0 0 1 1 1 1 1 0 0 0 0 6 6 0 0 0 1 0 1 1 1 1 1 0 1 1 6 6 6 0 0 0 0 0 1 1 1 1 1 0 1 1 0 0 0 0 0 0 0 1 0 0 1 0 0 0 0 0 1
1 0 0 0 0 0 1 0 0 0 0 0 1 0 0 1 0 0 0 0 0 0 1 0 0 0 0 0 1 0 1 1 0 0 0 0 0 0 0 0 0 0 0 0 1 0 1 1 0 0 0 0 0 0 0 0 1 1 0 0 0 0 0 0 1
1 0 0 2 0 0 1 1 1 1 1 1 1 0 0 1 0 0 0 2 0 0 1 1 1 1 1 1 1 0 1 1 0 0 0 2 0 0 0 1 1 1 1 1 1 0 1 1 0 1 0 0 0 1 0 1 1 1 1 0 1 0 0 0 1
1 0 2 2 0 0 0 0 0 0 0 0 0 0 0 1 0 0 2 2 0 0 0 0 0 0 0 0 0 0 1 1 0 0 2 2 0 0 0 0 0 0 0 0 0 0 1 1 0 1 1 0 1 1 0 1 0 0 1 0 1 0 0 0 1
1 0 2 2 2 0 0 0 0 0 0 0 0 0 0 1 0 0 2 2 2 0 0 0 0 0 0 0 0 0 1 1 0 0 2 2 2 0 0 0 0 0 0 0 0 0 1 1 0 1 1 1 1 1 0 1 1 1 1 0 1 0 0 0 1
1 0 2 2 2 2 0 0 0 0 0 0 0 0 0 1 0 0 2 2 2 2 0 0 0 0 0 0 0 0 0 1 0 0 2 2 2 2 0 0 0 0 0 0 0 0 0 0 0 1 0 1 0 1 0 1 0 0 1 0 1 0 0 0 1
1 0 0 0 0 0 0 0 0 0 0 0 0 0 0 1 0 0 0 0 0 0 0 0 0 0 0 0 0 0 0 1 0 0 0 0 0 0 0 0 0 0 0 0 0 0 0 1 0 1 0 0 0 1 0 1 0 0 1 0 1 1 1 0 1
1 0 2 2 2 2 0 0 0 0 0 0 0 0 0 1 0 0 2 2 2 2 0 0 0 0 0 0 0 0 1 1 0 0 2 2 2 2 0 0 0 0 0 0 0 0 1 1 0 0 0 0 0 0 0 0 0 0 0 0 0 0 0 0 1
1 0 0 2 2 0 0 0 0 0 0 0 0 0 0 1 0 0 0 2 2 0 0 0 0 0 0 0 0 0 1 1 0 0 0 2 2 0 0 0 0 0 0 0 0 0 1 1 0 0 0 0 0 0 0 0 0 0 0 0 0 0 0 0 1
1 1 1 1 1 1 1 1 1 1 1 1 1 1 1 1 1 1 1 1 1 1 1 1 1 1 1 1 1 1 1 1 1 1 1 1 1 1 1 1 1 1 1 1 1 1 1 1 1 1 1 1 1 1 1 1 1 1 1 1 1 1 1 1 1