10 10 10 10 10 10 10 10 10 10 10 10 10 10 10 10 10 10 10 10 10 10 10 10 10 10 10 10 10 10 10 10 10 10 10 10 10 10 10 10 10 10 10 10 10 10 10 10 10 10 10 10 10 10 10 10 10 10 10 10 10 10 10 10 10
10 44 13 13 13 13 10 10 10 10 10 10 10 10 13 10 44 44 13 13 13 13 13 13 13 13 13 13 13 13 13 10 44 44 44 13 13 13 10 10 10 10 10 10 10 10 13 13 13 44 44 44 44 13 13 10 10 10 10 10 10 10 10 13 10
10 13 13 13 13 13 10 13 13 13 13 13 13 13 13 10 13 13 13 13 44 13 44 13 44 13 44 13 44 13 44 10 13 13 13 13 13 13 10 13 13 13 13 13 13 13 13 10 13 13 13 13 13 13 10 13 13 13 13 13 13 13 10 13 10
10 13 12 13 13 13 10 13 10 10 10 10 10 13 13 10 13 13 12 13 13 44 13 44 13 44 13 44 13 44 13 10 13 13 13 13 13 13 10 13 10 10 10 10 10 13 13 10 13 13 13 13 13 13 10 13 13 13 13 13 13 13 10 13 10
10 13 13 13 13 13 10 13 13 13 13 13 10 13 13 10 13 13 13 13 44 13 21 16 16 16 16 16 16 16 20 10 13 13 13 13 13 13 10 13 13 13 13 13 10 13 13 10 13 13 13 13 13 13 10 13 13 13 13 13 10 13 10 13 10
10 13 13 13 13 13 10 10 10 10 10 13 10 13 13 10 13 13 13 12 13 44 19 14 14 14 14 14 14 14 18 10 13 13 13 14 13 13 10 10 10 10 10 10 10 13 13 13 13 13 13 13 13 13 10 10 10 10 10 10 10 13 10 13 10
10 13 21 16 20 13 13 13 12 13 13 13 13 13 13 10 13 13 13 13 44 13 19 14 14 14 14 14 14 14 18 10 13 13 14 14 13 13 13 13 13 13 13 13 13 13 13 10 13 13 14 14 13 13 13 13 13 13 13 13 13 13 10 13 10
10 13 19 14 14 20 12 13 13 13 13 13 13 13 13 10 13 13 13 13 13 44 19 14 14 14 14 17 17 17 22 10 13 13 14 14 14 13 13 13 13 13 13 13 13 13 13 10 13 13 14 14 14 13 13 13 13 13 13 13 13 13 10 13 10
10 13 23 17 17 22 12 13 13 13 13 13 13 13 13 10 13 13 13 13 44 44 23 14 14 14 22 12 13 13 13 10 13 13 14 14 14 14 13 13 13 13 13 13 13 13 13 10 13 13 14 14 14 14 13 13 13 13 13 13 13 13 13 13 10
10 13 13 13 13 13 13 13 13 13 13 13 13 13 13 10 13 21 20 13 13 13 13 23 17 22 13 13 12 13 13 10 13 13 13 13 13 13 13 13 13 13 13 13 13 13 13 10 13 13 13 13 13 13 13 13 13 13 13 13 13 13 13 13 10
10 13 21 16 16 20 13 13 13 13 13 13 13 13 13 13 13 19 14 20 44 12 13 13 13 13 13 13 13 13 10 10 13 13 14 14 14 14 13 13 13 13 13 13 13 13 13 10 13 13 14 14 14 14 13 13 13 13 13 13 13 13 10 13 10
10 13 23 17 17 22 13 13 13 13 12 13 13 13 10 10 13 19 14 18 13 44 12 12 13 13 13 13 13 13 10 10 13 13 13 14 14 13 13 13 13 13 13 13 13 13 13 10 13 13 13 14 14 13 13 13 13 13 13 13 13 13 10 13 10
10 10 10 10 10 10 10 10 10 10 10 10 10 10 10 10 10 10 10 10 10 10 10 10 10 10 10 10 10 13 10 10 10 10 10 10 10 10 10 10 10 10 10 10 10 10 13 10 13 10 10 10 10 10 10 10 10 10 10 10 10 10 10 10 10
10 41 36 36 36 36 36 36 36 36 36 36 36 36 40 10 44 44 44 44 12 13 13 12 13 13 13 13 13 13 13 10 44 44 44 44 13 13 13 13 13 13 13 13 13 13 13 10 13 44 44 44 44 13 10 10 10 10 10 10 10 10 10 13 10
10 39 34 34 34 34 34 34 34 34 34 34 34 34 38 10 44 44 12 13 13 13 10 13 13 13 13 13 12 13 13 10 44 44 44 13 13 13 10 13 13 13 13 13 13 13 13 10 13 44 44 44 44 13 13 13 13 10 13 13 13 13 13 13 10
10 39 34 34 34 34 34 34 34 34 34 34 34 34 38 10 13 13 13 13 13 13 10 45 45 45 45 45 45 13 13 10 13 13 13 13 13 13 10 13 10 10 10 10 10 13 13 10 13 13 13 13 13 13 10 13 10 10 10 10 10 13 10 13 10
10 39 34 34 34 34 34 34 34 34 34 34 34 34 38 10 13 12 13 12 13 13 10 45 45 45 45 45 45 12 13 10 13 13 13 13 13 13 10 13 13 13 13 13 10 13 13 10 13 13 13 13 13 13 10 13 13 13 13 13 10 13 10 13 10
10 39 34 34 34 34 34 34 34 34 34 34 34 34 38 13 13 13 12 13 13 13 10 10 10 10 10 10 10 13 13 10 13 13 13 14 13 13 10 10 10 10 10 10 10 13 13 10 13 13 13 14 13 13 10 10 10 10 10 10 10 13 10 13 10
10 39 34 34 34 34 34 34 34 34 34 34 34 34 38 10 13 13 13 13 13 13 13 13 13 13 12 13 13 13 13 10 13 13 14 14 13 13 13 13 13 13 13 13 13 13 13 10 13 13 14 14 13 13 13 13 13 13 13 13 13 13 10 13 10
10 39 34 34 34 34 34 34 34 34 34 34 34 34 38 10 16 16 16 16 16 16 16 16 16 16 16 16 16 16 16 10 13 13 14 14 14 13 13 13 13 13 13 13 13 13 13 10 13 13 14 14 14 13 13 13 13 13 13 13 13 13 10 13 10
10 39 34 34 34 34 34 34 34 34 34 34 34 34 38 10 14 14 14 14 14 14 14 14 14 14 14 14 14 14 14 10 13 13 14 14 14 14 13 13 13 13 13 13 13 13 13 10 13 13 14 14 14 14 13 13 13 13 13 13 13 13 13 13 10
10 39 34 34 34 34 34 34 34 34 34 34 34 34 38 10 24 24 24 24 46 24 24 24 24 24 24 24 24 24 24 10 13 13 13 13 13 13 13 13 13 13 13 13 13 13 13 10 13 13 13 13 13 13 13 13 13 13 13 13 13 13 13 13 10
10 39 34 34 34 34 34 34 34 34 34 34 34 34 38 10 24 24 46 24 24 24 46 24 24 24 24 24 24 24 24 10 13 13 14 14 14 14 13 13 13 13 13 13 13 13 13 10 13 13 14 14 14 14 13 13 13 13 13 13 13 13 10 13 10
10 43 37 37 37 37 37 37 37 37 37 37 37 37 42 10 24 24 24 24 24 24 24 24 24 24 24 24 24 24 24 24 24 24 24 24 24 24 24 24 24 24 24 24 24 24 24 10 13 13 13 14 14 13 13 13 13 13 13 13 13 13 10 13 10
10 13 10 10 10 10 10 10 10 10 10 10 10 10 10 10 13 10 10 10 10 10 10 10 10 10 10 10 10 10 10 10 10 10 10 10 10 10 10 10 10 10 10 10 10 10 10 10 10 10 10 10 10 10 10 10 10 10 10 10 10 10 10 13 10
10 13 44 44 44 44 44 13 13 13 13 13 13 13 13 10 13 44 44 44 44 44 13 13 13 13 13 13 13 13 13 10 44 44 44 44 44 44 14 14 14 14 14 14 14 14 14 10 44 44 44 44 44 44 13 13 13 13 13 13 13 13 13 13 10
10 13 44 44 44 44 13 13 13 13 13 13 13 13 13 10 13 44 44 44 44 44 10 13 13 13 13 13 13 13 13 10 44 44 44 44 44 13 10 13 13 13 13 13 13 13 10 10 44 44 44 44 44 44 10 13 13 13 13 13 13 13 13 13 10
10 13 13 13 13 13 13 13 10 10 10 10 10 13 13 10 13 13 13 13 13 13 10 13 10 10 10 10 10 13 13 10 13 13 13 13 13 13 10 13 10 10 10 10 10 13 10 10 13 13 13 13 13 13 10 13 10 10 10 10 10 13 13 13 10
10 12 13 13 13 13 10 13 13 13 13 13 10 13 13 10 13 13 13 13 13 13 10 13 13 13 13 13 10 13 13 10 13 13 13 13 13 13 10 13 13 13 13 13 10 13 10 10 13 13 13 13 13 13 10 13 13 13 13 13 10 13 13 13 10
10 13 12 13 13 13 10 10 10 10 10 10 10 13 13 10 13 13 13 14 13 13 10 10 10 10 10 10 10 13 13 10 13 13 13 14 13 13 10 10 10 10 10 10 10 13 10 10 13 13 13 14 13 13 10 10 10 10 10 10 10 13 13 13 10
10 13 12 21 20 13 13 13 13 13 13 13 13 13 13 10 13 13 14 14 13 13 13 13 13 13 13 13 13 13 13 10 13 13 14 14 13 13 13 13 13 13 13 13 13 13 13 10 13 13 14 14 13 13 13 13 13 13 13 13 13 13 13 13 10
10 13 13 19 14 20 13 13 13 13 12 13 13 13 13 10 13 13 14 14 14 13 13 13 13 13 13 13 13 13 13 10 13 13 14 14 14 13 13 13 13 13 13 13 13 13 13 10 13 13 14 14 14 13 13 13 13 13 13 13 13 13 13 13 10
10 13 13 19 14 14 20 13 13 13 13 13 12 13 13 10 13 13 14 14 14 14 13 13 13 13 13 13 13 13 13 10 13 13 14 14 14 14 13 13 13 13 13 13 13 13 13 10 13 13 14 14 14 14 13 13 13 13 13 13 13 13 13 13 10
10 13 13 19 14 14 18 12 13 13 13 13 13 13 13 10 13 13 13 13 13 13 13 13 13 13 13 13 13 13 13 10 13 13 13 13 13 13 13 13 13 13 13 13 13 13 13 10 13 13 13 13 13 13 13 13 13 13 13 13 13 13 13 13 10
10 12 13 19 14 14 18 13 13 13 13 13 13 13 13 10 13 13 14 14 14 14 13 13 13 13 13 13 13 13 13 10 13 13 14 14 14 14 13 13 13 13 13 13 13 13 13 10 13 13 14 14 14 14 13 13 13 13 13 13 13 13 13 13 10
10 13 13 23 17 17 22 13 12 13 13 12 13 13 13 10 13 13 13 14 14 13 13 13 13 13 13 13 13 13 13 10 13 13 13 14 14 13 13 13 13 13 13 13 13 13 13 13 13 13 13 14 14 13 13 13 13 13 13 13 13 13 13 13 10
10 10 13 10 10 10 10 10 10 10 10 10 10 10 10 10 10 10 10 10 10 10 10 10 10 10 10 10 10 13 10 10 10 10 10 10 10 10 13 10 10 10 10 10 10 10 10 10 10 10 10 10 10 10 10 10 10 10 10 10 10 10 10 10 10
10 44 13 44 44 44 44 44 13 13 13 13 13 13 13 10 44 44 44 44 44 44 13 10 10 10 10 10 10 13 10 10 44 44 44 44 44 44 13 10 10 10 10 10 10 10 10 10 13 13 13 13 13 13 13 13 13 13 13 13 13 13 13 13 10
10 44 13 44 44 44 44 44 13 13 13 13 13 13 13 10 44 44 44 44 44 44 13 13 13 13 13 13 13 13 10 10 44 44 44 44 44 44 13 13 13 13 13 13 13 13 10 10 13 13 13 13 13 13 13 13 10 10 13 13 13 13 13 13 10
10 44 13 13 13 13 13 13 10 10 10 10 10 13 13 13 13 44 44 13 13 13 10 13 10 10 10 10 10 13 10 10 44 44 44 13 13 13 13 13 10 10 10 10 10 13 10 10 13 13 13 13 13 13 13 10 13 13 10 13 13 13 13 13 10
10 13 13 13 13 13 10 13 13 13 13 13 10 13 13 10 13 13 13 13 13 13 10 13 13 13 13 13 10 13 10 10 13 13 13 13 13 13 13 13 13 13 13 13 10 13 10 10 13 13 13 13 13 13 13 13 10 10 13 13 13 13 13 13 10
10 13 13 13 13 13 10 10 10 10 10 10 10 13 13 10 13 13 13 14 13 13 10 10 10 10 10 10 10 13 10 10 13 13 13 14 13 13 13 10 10 10 10 10 10 13 10 10 13 10 13 13 13 10 13 10 10 10 10 13 10 13 13 13 10
10 13 13 13 13 13 13 12 13 13 13 13 13 13 13 10 13 13 14 14 13 13 13 13 13 13 13 13 13 13 10 10 13 13 14 14 13 13 13 13 13 13 13 13 13 13 10 10 13 10 10 13 10 10 13 10 13 13 10 13 10 13 13 13 10
10 13 12 13 13 13 13 13 13 13 13 13 13 13 13 10 13 13 14 14 14 13 13 13 13 13 13 13 13 13 10 10 13 13 14 14 14 13 13 13 13 13 13 13 13 13 10 10 13 10 10 10 10 10 13 10 10 10 10 13 10 13 13 13 10
10 13 13 13 12 13 13 13 12 13 13 13 13 13 13 10 13 13 14 14 14 14 13 13 13 13 13 13 13 13 13 10 13 13 14 14 14 14 13 13 13 13 13 13 13 13 13 13 13 10 13 10 13 10 13 10 13 13 10 13 10 13 13 13 10
10 13 13 13 13 13 13 13 13 13 13 13 13 13 13 10 13 13 13 13 13 13 13 13 13 13 13 13 13 13 13 10 13 13 13 13 13 13 13 13 13 13 13 13 13 13 13 10 13 10 13 13 13 10 13 10 13 13 10 13 10 10 10 13 10
10 13 13 13 13 13 13 12 13 13 13 13 13 13 13 10 13 13 14 14 14 14 13 13 13 13 13 13 13 13 10 10 13 13 14 14 14 14 13 13 13 13 13 13 13 13 10 10 13 13 13 13 13 13 13 13 13 13 13 13 13 13 13 13 10
10 13 13 12 13 13 13 13 13 13 13 13 13 13 13 10 13 13 13 14 14 13 13 13 13 13 13 13 13 13 10 10 13 13 13 14 14 13 13 13 13 13 13 13 13 13 10 10 13 13 13 13 13 13 13 13 13 13 13 13 13 13 13 13 10
10 10 10 10 10 10 10 10 10 10 10 10 10 10 10 10 10 10 10 10 10 10 10 10 10 10 10 10 10 10 10 10 10 10 10 10 10 10 10 10 10 10 10 10 10 10 10 10 10 10 10 10 10 10 10 10 10 10 10 10 10 10 10 10 10